000000#######000000
00000#000#00#000000
00000#00x000#000000
000###0#x000####000
000#00x00##x000#000
000#00#0j0x0#0x#000
000#00#000000x0####
000##0####0##00000#
000#0x#ppppp#0#000#
000#00xpp$$p0x#0###
00##00#ppppp#000#00
00#000###0#######00
00#0xx00#00#0000000
00#00#00000#0000000
00######000#0000000
0000000#####0000000
0000000000000000000