0000000000000000000
0000####00000000000
0000#00###########0
0000#0000x000x0x0#0
0000#0x#0x0#00x00#0
0000#00x0x00#0000#0
00###0x#0#00####0#0
00#0#x0x0x00##000#0
00#j000x0#x#000#0#0
00#000x0000x0x0x0#0
000####00#########0
0000#000000#0000000
0000#000000#0000000
0000#pppppp#0000000
0000#pppppp#0000000
0000#pppppp#0000000
0000########0000000
