0000000000000000000
0################00
0#00000000000000#00
0#0#0######00000#00
0#0#00x0x0x0x#00#00
0#0#000xjx000##0##0
0#0#0#x0x0x###ppp#0
0#0#000x0x00##ppp#0
0#0###xxx0x0##ppp#0
0#00000#0##0##ppp#0
0#####000##0##ppp#0
00000#####00000###0
000000000#00000#000
000000000#######000
0000000000000000000
0000000000000000000
0000000000000000000