0000000000000000000
0000000000000000000
000000000########00
000000000#00000j#00
000000000#0x#x0##00
000000000#0x00x#000
000000000##x0x0#000
0#########0x0#0###0
0#pppp00##0x00x00#0
0##ppp0000x00x000#0
0#pppp00##########0
0########0000000000
0000000000000000000
0000000000000000000