0000000000000000000
0000000000000000000
0000000000####00000
00000####0#00#00000
000###j0###x0#00000
00##000000x00#00000
0##00x0xx##0##00000
0#00#x##00000#00000
0#0#0x0xx0#0###0000
0#000x0#00#0x0#####
####0000#00xx0#000#
####0##0x000000000#
#p0000###00########
#pp0pp#0####0000000
#ppp#p#000000000000
#ppppp#000000000000
#######000000000000