0000000000000000000
0000000000000000000
0000000000000000000
00000000000#######0
00000000000#00ppp#0
0000000#####00ppp#0
0000000#000000p0p#0
0000000#00##00ppp#0
0000000##0##00ppp#0
000000###0########0
000000#0xxx0##00000
00#####00x0x0#####0
0##000#x0x000#000#0
0#j0x00x0000x00x0#0
0######0xx0x0#####0
000000#000000#00000
000000########00000