0000000000000000000
0000000000000000000
000######00###00000
000#pp00#0##j##0000
000#pp00###000#0000
000#pp00000xx0#0000
000#pp00#0#0x0#0000
000#pp###0#0x0#0000
000####0x0#x00#0000
000000#00x#0x0#0000
000000#0x00x00#0000
000000#00##000#0000
000000#########0000
0000000000000000000