0000000000000000000
0000000000000000000
0000#####0000000000
0000#000#0000000000
0000#x00#0000000000
00###00x##000000000
00#00x0x0#000000000
###0#0##0#000######
#000#0##0#####00pp#
#0x00x0000000000pp#
#####0###0#j##00pp#
0000#00000#########
0000#######00000000
0000000000000000000