0000000000000000000
000#########0000000
00##000##00#####000
###00000#00#0000###
#00x0#x0#00#00ppp0#
#0#0x#jx##0#0#p#p0#
#00#0#x00#0000p0p0#
#0x0000x0#0#0#p#p0#
#000##00##x0x0p0p0#
#0x0#000#00#x#p#p0#
##0x00x000x00xppp0#
0#x0######0000##00#
0#00#0000##########
0####00000000000000
0000000000000000000
0000000000000000000
0000000000000000000