0000000000000000000
0000000000000000000
0000############000
0000#pp00#00000###0
0000#pp00#0x00x00#0
0000#pp00#x####00#0
0000#pp0000j0##00#0
0000#pp00#0#00x0##0
0000######0##x0x0#0
000000#0x00x0x0x0#0
000000#0000#00000#0
000000############0
0000000000000000000
0000000000000000000