00000000#######0000
00#######00000#0000
00#00000#0xjx0#0000
00#xx0#000#########
00#0###pppppp##000#
00#000xpppppp##0#0#
00#0###pppppp00000#
0##000####0###0#x##
0#00#x000#00x00#0#0
0#00x0xxx00#0x##0#0
0#000x0x0###xx0#0#0
0#####00000x000#0#0
00000###0###000#0#0
0000000#00000#000#0
0000000########00#0
00000000000000####0
0000000000000000000