0000000000000000000
000000000#####00000
000#######000##0000
00##j#00##0xx0#0000
00#0000x000000#0000
00#00x00###000#0000
00###0#####x###0000
00#0x00###0pp#00000
00#0x0x0x0ppp#00000
00#0000###ppp#00000
00#0xx0#0#ppp#00000
00#00###0#####00000
00####0000000000000
0000000000000000000